ɑ	AA
æ	AE
ʌ	AH
ɔ	AO
aʊ	AW
ə	AX
aɪ	AY
ɛ	EH
ɝ	ER
eɪ	EY
ɪ	IH
ɨ	IX
i	IY
oʊ	OW
ɔɪ	OY
ʊ	UH
u	UW
b	B
tʃ	CH
d	D
ð	DH
ɾ	DX
l̩	EL
m̩	EM
n̩	EN
f	F
ɡ	G
h	HH
dʒ	JH
k	K
l	L
m	M
n	N
ŋ	NG
ɾ̃	NX
p	P
ʔ	Q
ɹ	R
s	S
ʃ	SH
t	T
θ	TH
v	V
w	W
ʍ	WH
j	Y
z	Z
ʒ	ZH
